0 1 2 3 4 6 5
0 1 2 3 5 6 4
0 1 2 4 3 6 5
0 1 2 5 3 6 4
0 1 3 4 2 6 5
0 1 3 5 2 6 4
0 2 1 3 4 5 6
0 2 1 3 4 6 5
0 2 1 3 5 6 4
0 2 1 4 3 5 6
0 2 1 4 3 6 5
0 2 1 5 3 6 4
0 3 1 4 2 5 6
0 3 1 4 2 6 5
0 3 1 5 2 6 4
1 2 0 3 4 5 6
1 2 0 3 4 6 5
1 2 0 3 5 6 4
1 2 0 4 3 6 5
1 2 0 5 3 6 4
1 3 0 4 2 6 5
1 3 0 5 2 6 4
