0 1 2 4 3
0 1 3 4 2
0 2 1 3 4
0 2 1 4 3
0 3 1 4 2
1 2 0 3 4
1 2 0 4 3
1 3 0 4 2
